11111111111
10000000001
1000P0E0001
11111111111
