11111111111
10000000001
1000PEC0001
11110111111
