11111111111
10000000000
1000PEC0001
11111111111
