1111111
1111111
1111111
1P11111
1PCE111
1111111
