11111111111
10000000001
1000E0C0001
11111111111
