1111111111111
10C10C00000C1
1000011011001
1P001100C0001
1111110111111
1111110111111
1C010000000C1
1010011011001
100011E0C0001
1111111111111
