1111111111111
10010000000C1
1000011011001
100011EPC0001
1111111111111
